/services/pereezdy/	/pereezdy
/services/pereezd-voronezh/	/pereezdy
/services/kvartirnyj-pereezd/	/pereezdy/kvartirnyy-pereezd
/services/pereezd-domashnij/	/pereezdy/domashniy-pereezd
/services/dachnyj-pereezd/	/pereezdy/dachnyy-pereezd
/services/perevozka-mebeli/	/gruzoperevozki/perevozka-mebeli
/services/perevozka-veshhej/	/gruzoperevozki/perevozka-veschey
/services/pereezd-po-oblasti/	/pereezdy
/services/pereezd-po-voronezhskoj-oblasti/	/pereezdy
/services/pereezd-po-rossii/	/pereezdy
/services/pereezd-v-drugoj-gorod/	/pereezdy
/services/pereezd-voennosluzhashhih/	/pereezdy/pereezd-voennosluzhaschih
/kalkulyator-po-pereezdam/	/calc
/upakovka/	/gruzchiki/upakovka
/services/takelazhnye-raboty/	/gruzchiki/takelazh
/services/gruzoperevozki/	/gruzoperevozki
/services/gruzoperevozki-mezhgorod/	/gruzoperevozki/perevozki-mezhdugorodnye
/services/gruzoperevozki-po-oblasti/	/gruzoperevozki/perevozki-po-oblasti
/services/perevozka-oborudovaniya/	/gruzchiki/perevozka-stankov
/services/gruzoperevozki-po-rossii/	/gruzoperevozki/perevozki-po-rossii
/services/poputno-i-dogruzom/	/gruzoperevozki/perevozki-poputnye
/services/gruzovoe-taksi/	/gruzoperevozki/gruzovoe-taksi
/services/dostavka/	/gruzoperevozki
/kalkulyator-po-perevozkam/	/calc
/services/uslugi-gruzchikov/	/gruzchiki
/services/razgruzka-i-pogruzka-vagonov/	/gruzchiki/razgruzka-vagonov
/services/razgruzka-kontejnerov/	/gruzchiki/razgruzka-konteynerov
/services/razgruzka-fur-gazelej/	/gruzchiki/razgruzka-fur
/services/podem-strojmaterialov/	/gruzchiki/pod-em-stroy-materialov
/services/vynos-stroitelnogo-musora/	/gruzchiki/vynos-stroitel-nogo-musora
/services/gruzchiki-na-pereezd/	/gruzchiki
/services/sborka-razborka-mebeli/	/gruzchiki/sborka-mebeli
/services/razborka-mebeli/	/gruzchiki/sborka-mebeli
/services/upakovka-mebeli/	/gruzchiki/upakovka
/services/pogruzka-byt-tehniki/	/gruzoperevozki/perevozka-mebeli
/services/gruzchiki-s-transportom/	/gruzchiki
/services/perevozka-pianino/	/gruzchiki/perevozka-pianino
/services/pogruzka-gabaritnoj-mebeli/	/gruzoperevozki/perevozka-mebeli
/services/pogruzka-sejfa/	/gruzchiki/perevozka-seyfa
/services/perevozka-oborudovaniya/	/gruzchiki/perevozka-stankov
/services/perevozka-bankomatov/	/gruzchiki/perevozka-bankomata
/services/uborka-snega/	/gruzchiki/uslugi-raznorabochih
/services/zemlyanye-raboty/	/gruzchiki/uslugi-raznorabochih
/services/gruzchik-na-chas/	/gruzchiki/na-chas
/services/uslugi-raznorabochih/	/gruzchiki/uslugi-raznorabochih
/services/pereezd-ofisnyj/	/pereezdy/ofisnyy-pereezd
/services/pereezd-restorana/	/pereezdy/pereezd-kafe
/services/pereezd-magazina/	/pereezdy/pereezd-magazina
/services/pereezd-sklada/	/pereezdy/pereezd-sklada
/kalkulyator-dlya-yur-licz/	/calc
/services/dostavka-dlya-magazinov/	/gruzoperevozki
/services/fulfillment/	/dlya-yur-lic/fulfilment
/services/dostavka-dlya-internet-magazinov/	/gruzoperevozki
/projects/poputno-i-dogruzom/	/gruzoperevozki/perevozki-poputnye
/services/hranenie-na-sklade/	/dlya-yur-lic/sklad-otvetvennogo-hranenniya
/services/autsorsing-dlya-yur-licz/	/dlya-yur-lic/autsorsing
/services/autsorsing/	/dlya-yur-lic/autsorsing
/avtopark/	/avtopark
/mashiny-dlya-pereezda/	/avtopark
/gazeli-dlya-pereezda/	/avtopark/gazeli
/mashiny-dlya-perevozok/	/avtopark
/gazeli-dlya-perevozok/	/avtopark/gazeli
/kontakty/	/kontakty
/o-kompanii/	/o-kompanii
/portfolio/	/o-kompanii
/reviews/	/o-kompanii/otzyvy
/nashi-partnery/	/o-kompanii
/nashi-tarify/	/tarify
/reviews/kubrak-olga/	/o-kompanii/otzyvy
/reviews/otzyv-2/	/o-kompanii/otzyvy
/portfolio/upakovka-dlya-pereezda-i-hraneniya/	/o-kompanii
/portfolio/453/	/o-kompanii
/reviews/otzyv-1/	/o-kompanii/otzyvy
/portfolio/key-1/	/o-kompanii
/services/perevozka-medicinskogo-oborudovaniya/	/gruzchiki/perevozka-med-oborudovaniya
/services/perevozka-stankov/	/gruzchiki/perevozka-stankov
/services/perevozka-koncertnogo-oborudovaniya/	/gruzchiki/takelazh
/services/perevozka-holodilnika/	/gruzoperevozki/perevozka-mebeli
/category/posts/	/article
/dokumenty/	/o-kompanii/dokumenty
/vakansii/	/o-kompanii/vakansii
/mashina-dlya-pereezda-kakoj-ona-dolzhn/	/article/mashina-dlya-pereezda-kakoj-ona-dolzhn
/zadacha-organizaczii-v-osobennosti-zhe-s/	/article/zadacha-organizaczii-v-osobennosti-zhe-s
/kak-bystro-i-pravilno-sobrat-veshhi-dl/	/article/kak-bystro-i-pravilno-sobrat-veshhi-dl
/vakansii/gruzchik-ehkspeditor/	 /o-kompanii/vakansii/gruzchik-ehkspeditor
/vakansii/gruzchik/	 /o-kompanii/vakansii/gruzchik
/vakansii/voditel/	 /o-kompanii/vakansii/voditel
/vakansii/takelazhnik/	 /o-kompanii/vakansii/takelazhnik
/vakansii/gruzchik-komplektovshchik/	/o-kompanii/vakansii/gruzchik-komplektovshchik
/dokumenty/politika-obrabotki-personalnyh-dannyh/	 /o-kompanii/dokumenty/politika-obrabotki-personal-nyh-dannyh
/dokumenty/liczenziya-na-vedenie-deyatelnosti/	 /o-kompanii/dokumenty/liczenziya-na-vedenie-deyatelnosti
/dokumenty/publichnaya-oferta/	 /o-kompanii/dokumenty/publichnaya-oferta
/dokumenty/polzovatelskoe-soglashenie/	 /o-kompanii/dokumenty/polzovatelskoe-soglashenie
/politika	 /o-kompanii/dokumenty/politika-obrabotki-personal-nyh-dannyh
/o-kompanii/avtopark/	/avtopark
/\?p=472	/avtopark
/\?p=722	/o-kompanii/dokumenty
/\?p=732	/o-kompanii/dokumenty/liczenziya-na-vedenie-deyatelnosti
/\dokumenty/politika-obrabotki-personalnyh-dannyh	/o-kompanii/dokumenty/politika-obrabotki-personal-nyh-dannyh
/\?p=728	/o-kompanii/dokumenty/politika-obrabotki-personal-nyh-dannyh
/\?p=735	/o-kompanii/dokumenty/polzovatelskoe-soglashenie
/\?p=730	/o-kompanii/dokumenty/publichnaya-oferta
/\?p=1257	/avtopark/gazeli
/\?p=1298	/avtopark/gazeli
/\?p=132	/article/kak-bystro-i-pravilno-sobrat-veshhi-dl
/kalkulyator/	/calc
/\?p=1034	/calc
/\?p=665	/calc
/\?p=926	/calc
/\?p=38	/kontakty
/\?p=135	/article/mashina-dlya-pereezda-kakoj-ona-dolzhn
/\?p=1276	/avtopark
/\?p=1312	/avtopark
/\?p=232	/o-kompanii
/\?p=536	/tarify
/\?p=45	/o-kompanii
/\?p=453	/o-kompanii
/\?p=127	/o-kompanii
/\?p=184	/o-kompanii
/projects/buryakov-mezhgorod/	/gruzoperevozki/perevozki-poputnye
/\?p=586	/gruzoperevozki/perevozki-poputnye
/\?p=1156	/dlya-yur-lic/autsorsing
/\?p=755	/pereezdy/dachnyy-pereezd
/\?p=1098	/gruzoperevozki
/services/dostavka-pod-klyuch/	/gruzoperevozki
/\?p=857	/gruzoperevozki
/\?p=858	/dlya-yur-lic/fulfilment
/\?p=1241	/gruzchiki
/\?p=1102	/gruzchiki
/\?p=1145	/gruzchiki/na-chas
/\?p=680	/gruzoperevozki
/\?p=1290	/gruzoperevozki/perevozki-mezhdugorodnye
/\?p=1293	/gruzoperevozki/perevozki-po-oblasti
/\?p=1075	/gruzoperevozki/perevozki-po-rossii
/\?p=1087	/gruzoperevozki/gruzovoe-taksi
/\?p=269	/dlya-yur-lic/sklad-otvetvennogo-hranenniya
/\?p=750	/pereezdy/kvartirnyy-pereezd
/\?p=103	/pereezdy/domashniy-pereezd
/\?p=835	/pereezdy/pereezd-magazina
/\?p=105	/pereezdy/ofisnyy-pereezd
/\?p=1231	/pereezdy
/\?p=1238	/pereezdy
/\?p=1235	/pereezdy
/\?p=842	/pereezdy/pereezd-kafe
/\?p=838	/pereezdy/pereezd-sklada
/\?p=248	/pereezdy/pereezd-voennosluzhaschih
/\?p=1215	/pereezdy
/\?p=1203	/pereezdy
/\?p=845	/gruzchiki/perevozka-bankomata
/\?p=807	/gruzoperevozki/perevozka-mebeli
/\?p=853	/gruzchiki/takelazh
/\?p=789	/gruzoperevozki/perevozka-mebeli
/\?p=806	/gruzchiki/perevozka-med-oborudovaniya
/\?p=805	/gruzchiki/perevozka-stankov
/\?p=803	/gruzchiki/perevozka-pianino
/\?p=852	/gruzchiki/perevozka-stankov
/services/perevozka-veshhej	/gruzoperevozki/perevozka-veschey
/\?p=1099	/gruzchiki/pod-em-stroy-materialov
/\?p=1125	/gruzoperevozki/perevozka-mebeli
/\?p=1128	/gruzoperevozki/perevozka-mebeli
/\?p=1129	/gruzchiki/perevozka-seyfa
/\?p=1198	/gruzoperevozki/perevozki-poputnye
/\?p=759	/gruzchiki/sborka-mebeli
/\?p=1121	/gruzchiki/razgruzka-fur
/\?p=1093	/gruzchiki/razgruzka-vagonov
/\?p=1118	/gruzchiki/razgruzka-konteynerov
/\?p=268	/gruzchiki/sborka-mebeli
/\?p=270	/gruzchiki/takelazh
/\?p=1134	/gruzchiki/uslugi-raznorabochih
/\?p=1101	/gruzchiki/upakovka
/\?p=796	/gruzchiki
/\?p=1152	/gruzchiki/uslugi-raznorabochih
/\?p=1100	/gruzchiki/vynos-stroitel-nogo-musora
/\?p=1139	/gruzchiki/uslugi-raznorabochih
/\?p=693	/gruzchiki/upakovka
/\?p=577	/o-kompanii/vakansii
/\?p=818	/o-kompanii/vakansii/gruzchik
/\?p=816	/o-kompanii/vakansii/gruzchik-ehkspeditor
/\?p=814	/o-kompanii/vakansii/gruzchik-komplektovshchik
/\?p=810	/o-kompanii/vakansii/takelazhnik
/\?p=808	/o-kompanii/vakansii/voditel
/\?p=118	/article/zadacha-organizaczii-v-osobennosti-zhe-s
